+-----------+
|XXXXXXXXXXX|
|XpX.......X|
|X.X....mX.X|
|X.......X.X|
|X.......X.X|
|X...m...X!X|
|X......XX.X|
|X.X.XXXX..X|
|XpX.-.....D|
|XXXXXXXXXDX|
+-----------+
|XXXXXXXXXXX|
|XpX.......X|
|X.X....mX.X|
|X.......X.X|
|X.......X.X|
|X...m...X.X|
|X......XX.X|
|X.X.XXXX..X|
|XpX.-.....D|
|XXXXXXXXXDX|
+-----------+
|XXXXXXXXXXX|
|XpX.......X|
|X.X....mX.X|
|X.......X.X|
|X.......X.X|
|X...m...X!X|
|X......XX.X|
|X.X.XXXX..X|
|XpX.-.....D|
|XXXXXXXXXDX|
+-----------+
|XXXXXXXXXXX|
|XpX.......X|
|X.X.....X.X|
|X.......X.X|
|X...G...X.X|
|X.......X.X|
|X......XX.X|
|X.X.XXXX..X|
|XpX.......D|
|XXXXXXXXXDX|
+-----------+
|XXXXXXXXXXX|
|XpX.......X|
|X.X.......X|
|X.........X|
|X...G.....X|
|X.........X|
|X.........X|
|X.X.......X|
|XpX.......D|
|XXXXXXXXXDX|
+-----------+
|XXXXXXXXXXX|
|Xpp.......X|
|Xpp....m..X|
|X.........X|
|X...m.....X|
|X.........X|
|X.........X|
|X......m..X|
|X.........D|
|XXXXXXXXXDX|
+-----------+
|XXXXXXXXXXX|
|Xpp.......X|
|Xpp.......X|
|X..-......X|
|X...-.....X|
|X...-.....X|
|X..-......X|
|X...-.....X|
|X....-....D|
|XXXXXXXXXDX|
+-----------+
|XXXXXXXXXXX|
|Xpp.......X|
|Xpp...!...X|
|X.........X|
|X.......!.X|
|X.........X|
|X.......!.X|
|X......!..X|
|X.........D|
|XXXXXXXXXDX|
+-----------+
|XXXXXXXXXXX|
|Xpp.......X|
|Xpp.......X|
|X.........X|
|X....G....X|
|X.........X|
|X.........X|
|X.........X|
|X.........D|
|XXXXXXXXXDX|
+-----------+
|XXXXXXXXXXX|
|Xpp.....$$X|
|Xpp....m$$X|
|X.........X|
|X....m..m.X|
|X..m......X|
|X.....m...X|
|X.........X|
|X.........D|
|XXXXXXXXXDX|
+-----------+
|XXXXXXXXXXX|
|Xpp.....$$X|
|Xpp.....$$X|
|X.........X|
|X....G....X|
|X.........X|
|X.........X|
|X.........X|
|X.........D|
|XXXXXXXXXDX|
+-----------+
|XXXXXXXXXXX|
|Xpp.......X|
|Xpp....m..X|
|X.........X|
|X....m..m.X|
|X..m......X|
|X.....m...X|
|X.........X|
|X.........D|
|XXXXXXXXXDX|
+-----------+
|XXXXXXXXXXX|
|Xpp.......X|
|X.X...m.X.X|
|X..X...X..X|
|X...X.X...X|
|X....X.m..X|
|X...X.X...X|
|X..X...X..X|
|X.X.....X.X|
|X.........D|
|XXXXXXXXXDX|
+-----------+
|XXXXXDXXXXX|
|X...X.X...X|
|X.p.X.X.p.X|
|X...X.X...X|
|XXXXX.XXXXX|
|D.........D|
|D.........D|
|XXXXX.XXXXX|
|X...X.X...X|
|X.p.X.X.p.X|
|X...X.X...X|
|XXXXXDXXXXX|
+-----------+
|XXXXXDXXXXX|
|X...X.X...X|
|X.m.X.X.m.X|
|X...X.X...X|
|XXXXX.XXXXX|
|D....m....D|
|D.........D|
|XXXXX.XXXXX|
|X...X.X...X|
|X.p.X.X.m.X|
|X...X.X...X|
|XXXXXDXXXXX|
+-----------+
|XXXXXDXXXXX|
|X...X.X...X|
|X.$.X.X.G.X|
|X...X.X...X|
|XXXXX.XXXXX|
|D....m....D|
|D.........D|
|XXXXX.XXXXX|
|X...X.X...X|
|X.p.X.X.m.X|
|X...X.X...X|
|XXXXXDXXXXX|
+-----------+
|XXXXXDXXXXX|
|X...X.X...X|
|X.$.X.X.m.X|
|X...X.X...X|
|XXXXX.XXXXX|
|D.........D|
|D....G....D|
|D.........D|
|D.........D|
|XXXXX.XXXXX|
|X...X.X...X|
|X.p.X.X.m.X|
|X...X.X...X|
|XXXXXDXXXXX|
+-----------+
|XXXXXDXXXXX|
|X...X.X...X|
|X.$.X.X.p.X|
|X...X.X...X|
|XXXXX.XXXXX|
|D.........D|
|D....G....D|
|D.........D|
|D.........D|
|XXXXX.XXXXX|
|X...X.X...X|
|X.p.X.X.m.X|
|X...X.X...X|
|XXXXXDXXXXX|
+-----------+
|XXXXXDXXXXX|
|X...X.XpppX|
|X.$.X.XpppX|
|X...X.XpppX|
|XXXXX.XXXXX|
|D.........D|
|D....m....D|
|D.........D|
|D.........D|
|XXXXX.XXXXX|
|X...X.X...X|
|X.p.X.X.G.X|
|X...X.X...X|
|XXXXXDXXXXX|
+-----------+
|XXXXXDXXXXX|
|X...X.X...X|
|X.m.X.X.G.X|
|X...X.X...X|
|XXXXX.XXXXX|
|D.........D|
|D...$$$...D|
|D...$$$...D|
|D.........D|
|XXXXX.XXXXX|
|X...X.X...X|
|X.p.X.X.G.X|
|X...X.X...X|
|XXXXXDXXXXX|
+-----------+
