+-----------+
|XXXXXXXXXXX|
|XpX.......X|
|X.X....mX.X|
|X.......X.X|
|X...X...X.X|
|X...m...X!X|
|X......XX.X|
|X.X.XXXX..X|
|XpX.-.....D|
|XXXXXXXXXDX|
+-----------+
|XXXXXXXXXXX|
|XpX.......X|
|X.X....mX.X|
|X....X..X.X|
|X..X....X.X|
|X...m...X.X|
|X......XX.X|
|X.X.XXXX..X|
|XpX.-.....D|
|XXXXXXXXXDX|
+-----------+
|XXXXXXXXXXX|
|XpX..G....X|
|X.X....mX.X|
|X.......X.X|
|X.......X.X|
|X.G.m...X!X|
|X......XX.X|
|X.X.XXXX..X|
|XpX.-.....D|
|XXXXXXXXXDX|
+-----------+
|XXXXXXXXXXX|
|XpX.......X|
|X.X.XXX.X.X|
|X.......X.X|
|X...M.G.X.X|
|X.G.....X.X|
|X......XX.X|
|X.X.XXXX..X|
|XpX.......D|
|XXXXXXXXXDX|
+-----------+
|XXXXXXXXXXX|
|XpX.......X|
|X.X...X.G.X|
|X.....X...X|
|X...M.X.G.X|
|X.....X...X|
|X.....X.G.X|
|X.X...X...X|
|XpX.......D|
|XXXXXXXXXDX|
+-----------+
|XXXXXXXXXXX|
|Xpp.......X|
|XppG.G.G..X|
|X.........X|
|X..G.G.G..X|
|X.........X|
|X..G.G.G..X|
|X.........X|
|X.........D|
|XXXXXXXXXDX|
+-----------+
|XXXXXXXXXXX|
|Xpp.X.G...X|
|Xpp.X.XXX.X|
|X..-....XGX|
|X...-...X.X|
|X...-...X.X|
|X..-....X.X|
|X...-...X.X|
|X....-..X.D|
|XXXXXXXXXDX|
+-----------+
|XXXXXXXXXXX|
|Xpp..G....X|
|Xpp...!...X|
|X.........X|
|X.......!.X|
|X.........X|
|X.......!.X|
|X......!..X|
|X.........D|
|XXXXXXXXXDX|
+-----------+
|XXXXXXXXXXX|
|Xpp.......X|
|Xpp.......X|
|X.........X|
|X....M....X|
|X.........X|
|X.........X|
|X.........X|
|X.........D|
|XXXXXXXXXDX|
+-----------+
|XXXXXXXXXXX|
|Xpp.....$$X|
|Xpp....m$$X|
|X.........X|
|X....m..m.X|
|X..m......X|
|X.....m...X|
|X.........X|
|X.........D|
|XXXXXXXXXDX|
+-----------+
|XXXXXXXXXXX|
|Xpp.....$$X|
|Xpp..X..$$X|
|X.........X|
|X....M....X|
|X.........X|
|X....X....X|
|X..X...X..X|
|X.........D|
|XXXXXXXXXDX|
+-----------+
|XXXXXXXXXXX|
|Xpp.......X|
|Xpp....m..X|
|X.........X|
|X....m..m.X|
|X..m......X|
|X.....m...X|
|X.........X|
|X.........D|
|XXXXXXXXXDX|
+-----------+
|XXXXXXXXXXX|
|Xpp.......X|
|X.X...m.X.X|
|X..X...X..X|
|X...X.X...X|
|X....X.m..X|
|X...X.X...X|
|X..X...X..X|
|X.X.....X.X|
|X.........D|
|XXXXXXXXXDX|
+-----------+
|XXXXXDXXXXX|
|X...X.X...X|
|X.p.X.X.p.X|
|X...X.X...X|
|XXXXX.XXXXX|
|D.........D|
|D..M......D|
|D.........D|
|D.........D|
|XXXXX.XXXXX|
|X...X.X...X|
|X.p.X.X.p.X|
|X...X.X...X|
|XXXXXDXXXXX|
+-----------+
|XXXXXDXXXXX|
|X...X.X...X|
|X.m.X.X.m.X|
|X...X.X...X|
|XXXXX.XXXXX|
|D.........D|
|D....m....D|
|D.........D|
|XXXXX.XXXXX|
|X...X.X...X|
|X.p.X.X.m.X|
|X...X.X...X|
|XXXXXDXXXXX|
+-----------+
|XXXXXDXXXXX|
|X...X.X...X|
|X.$.X.X.M.X|
|X...X.X...X|
|XXXXX.XXXXX|
|D...G.G...D|
|D....G....D|
|D...G.G...D|
|XXXXX.XXXXX|
|X...X.X...X|
|X.p.X.X.m.X|
|X...X.X...X|
|XXXXXDXXXXX|
+-----------+
|XXXXXDXXXXX|
|X...X.X...X|
|X.$.X.X.m.X|
|X...X.X...X|
|XXXXX.XXXXX|
|D.........D|
|D.X.....X.D|
|D.........D|
|D.........D|
|D....M....D|
|D.........D|
|D.........D|
|D.X.....X.D|
|D.........D|
|XXXXX.XXXXX|
|X...X.X...X|
|X.p.X.X.m.X|
|X...X.X...X|
|XXXXXDXXXXX|
+-----------+
|XXXXXDXXXXX|
|X...X.X...X|
|X.$.X.X.p.X|
|X...X.X...X|
|XXXXX.XXXXX|
|D.........D|
|D.X.....X.D|
|D....M....D|
|D.X.....X.D|
|D.........D|
|XXXXX.XXXXX|
|X...X.X...X|
|X.p.X.X.m.X|
|X...X.X...X|
|XXXXXDXXXXX|
+-----------+
|XXXXXDXXXXX|
|X...X.XpppX|
|X.$.X.XpppX|
|X...X.XpppX|
|XXXXX.XXXXX|
|D.........D|
|D.........D|
|D....m....D|
|D.........D|
|D.........D|
|XXXXX.XXXXX|
|X...X.X...X|
|X.p.X.X.M.X|
|X...X.X...X|
|XXXXXDXXXXX|
+-----------+
|XXXXXDXXXXX|
|X...X.X...X|
|X.m.X.XmM.X|
|X...X.X...X|
|XXXXX.XXXXX|
|D.........D|
|D...$$$...D|
|D..$$$$$..D|
|D..$$$$$..D|
|D...$$$...D|
|D.........D|
|XXXXX.XXXXX|
|X...X.X...X|
|X.p.X.X.M.X|
|X...X.X...X|
|XXXXXDXXXXX|
+-----------+
