+------------+
|XXXXXXXXXXXX|
|XGGp$m.$.pGX|
|Xm...m..$.pX|
|X.m.$.m...$X|
|X.$..m...$.X|
|XG..m....mGX|
|X====DD====X|
+------------+
|XXXXXXXXXXXX|
|XG.p$__$.pGX|
|Xm...m..$.pX|
|X.m.$.m...$X|
|X.$..m...$.X|
|XG..m....mGX|
|X==========X|
+------------+
|XXXXXXXXXXXX|
|XGGp$m.$.pGX|
|Xm...m..$.pX|
|X.m.$.m...$X|
|X.$..m...$.X|
|XG..m....mGX|
|X====DD====X|
+------------+
|XXXXXXXXXXXX|
|XG.p$__$.pGX|
|Xm...m..$.pX|
|X.m.$.m...$X|
|X.$..m...$.X|
|XG..m....mGX|
|X==========X|
+------------+
|XXXXXXXXXXXX|
|XGGp$m.$.pGX|
|Xm...m..$.pX|
|X.m.$.m...$X|
|X.$..m...$.X|
|XG..m....mGX|
|X====DD====X|
+------------+
|XXXXXXXXXXXX|
|XG.p$__$.pGX|
|Xm...m..$.pX|
|X.m.$.m...$X|
|X.$..m...$.X|
|XG..m....mGX|
|X==========X|
+------------+
|XXXXXXXXXXXX|
|XG.p$__$.pGX|
|Xm...m..$.pX|
|X.m.$.m...$X|
|X.$..m...$.X|
|XG..m....mGX|
|XXXXX==XXXXX|
|    X==X    |
|    X==X    |
|    X==X    |
|    X==X    |
|    XDDX    |
+------------+
|XXXXXXXXXXXX|
|X..........X|
|X.========.X|
|X.=......=.X|
|X.=......=.X|
|X.=......=.X|
|X.=..G_..=.X|
|X.=......=.X|
|X.=......=.X|
|X.=......=.X|
|X.========.X|
|X..........X|
|XXXXX..XXXXX|
|    X..X    |
|    X..X    |
|    X..X    |
|    X..X    |
|    XDDX    |
+------------+
|XXXXXXXXXXXX|
|X..........X|
|X.========.X|
|X.=.$..$.=.X|
|X.=......=.X|
|X.=......=.X|
|X.=..G_..=.X|
|X.=......=.X|
|X.=.$..$.=.X|
|X.=..$...=.X|
|X.========.X|
|X..........X|
|XXXXX..XXXXX|
|    X..X    |
|    X..X    |
|    X..X    |
|    X..X    |
|    XDDX    |
+------------+
|XXXXXXXXXXXX|
|X..........X|
|X.========.X|
|X.=G$p.$G=.X|
|X.=.....p=.X|
|X.=......=.X|
|X.=p.G_..=.X|
|X.=.$..$.=.X|
|X.=......=.X|
|X.=G.$..G=.X|
|X.========.X|
|X..........X|
|XXXXX..XXXXX|
|    X..X    |
|    X..X    |
|    X..X    |
|    X..X    |
|    XDDX    |
+------------+
|XXXXXXXXXXXX|
|X..........X|
|X.========.X|
|X.=......=.X|
|X.=......=.X|
|X.=......=.X|
|X.=..G_..=.X|
|X.=......=.X|
|X.=......=.X|
|X.=......=.X|
|X.========.X|
|X..........X|
|XXXXX..XXXXX|
|    X..X    |
|    X..X    |
|    X..X    |
|    X..X    |
|    XDDX    |
+------------+
|XXXXXXXXXXXX|
|X..........X|
|X.========.X|
|X.=.$..$.=.X|
|X.=......=.X|
|X.=......=.X|
|X.=..G_..=.X|
|X.=.$..$.=.X|
|X.=......=.X|
|X.=..$...=.X|
|X.========.X|
|X..........X|
|XXXXX..XXXXX|
|    X..X    |
|    X..X    |
|    X..X    |
|    X..X    |
|    XDDX    |
+------------+
|XXXXXXXXXXXX|
|X..........X|
|X.========.X|
|X.=.$p.$.=.X|
|X.=......=.X|
|X.=.....p=.X|
|X.=p..G..=.X|
|X.=.$..$.=.X|
|X.=......=.X|
|X.=..$...=.X|
|X.========.X|
|X..........X|
|XXXXX..XXXXX|
|    X..X    |
|    X..X    |
|    X..X    |
|    X..X    |
|    XDDX    |
+------------+
|XXXXXXXXXXXX|
|X$$$$$$$$$$X|
|XXXXXXXXXXXX|
|X..........X|
|X.========.X|
|X.=......=.X|
|X.=......=.X|
|X.=......=.X|
|X.=..G_..=.X|
|X.=......=.X|
|X.=......=.X|
|X.=......=.X|
|X.========.X|
|X..........X|
|XXXXX..XXXXX|
|    X..X    |
|    X..X    |
|    X..X    |
|    X..X    |
|    XDDX    |
+------------+
|XXXXXXXXXXXX|
|X..........X|
|X.========.X|
|X.=.$..$.=.X|
|X.=......=.X|
|X.=......=.X|
|X.=..G_..=.X|
|X.=.$..$.=.X|
|X.=......=.X|
|X.=..$...=.X|
|X.========.X|
|X..........X|
|XXXXX..XXXXX|
|    X..X    |
|    X..X    |
|    X..X    |
|    X..X    |
|    XDDX    |
+------------+
|XXXXXXXXXXXX|
|X$$$$$$$$$$X|
|XXXXXXXXXXXX|
|X..........X|
|X.========.X|
|X.=......=.X|
|X.=.$p.$.=.X|
|X.=...G.p=.X|
|X.=p.._..=.X|
|X.=......=.X|
|X.=.$..$.=.X|
|X.=......=.X|
|X.=..$...=.X|
|X.========.X|
|X..........X|
|XXXXX..XXXXX|
|    X..X    |
|    X..X    |
|    X..X    |
|    X..X    |
|    XDDX    |
+------------+
|XXXXXXXXXXXX|
|X.-.......-X|
|X....-.....X|
|X..XXXXXX..X|
|X..XXXXXX..X|
|X..XXpEXX..X|
|X..XXppXX..X|
|X!..XppXX!.X|
|X.!XX$XXX..X|
|X..XX$.XX.!X|
|X..XXX.XX..X|
|X..XX..XX..X|
|X..XX..XX..X|
|X..XX..XX..X|
|X..XX..XX..X|
|X..XX..XX..X|
|X..XX..XX..X|
|X..XX..X...X|
|X...X..XX..X|
|X..XX!.XX..X|
|X..XX.!XX..X|
|X..XX..XX..X|
|X..XX..-...X|
|X..XX.-....X|
|X..XXXXXXXXX|
|X..XXXXXXXXX|
|X.........-X|
|X....-.....X|
|XXXXXXXXXDDX|
+------------+
