+------------------------------+
|XXXXXXXXXXXXXXXXXXXXXXXXXXXXXX|
|X..........................-.X|
|X...........................-X|
|X........................-...X|
|X............."...........-..X|
|X..........................-.X|
|X...........................-X|
|X....""".....................X|
|X...."$"!!!!!!!!!!!!!!!!!XXXXX|
|X....""".................X$$TX|
|X..XXX"X.................X$$$X|
|X.....GXXXXX.X.XX.XXXXX..X$$$X|
|X.X....XXXX$.$.X$$X..d...X$$$X|
|X.XX$..XX$XX.$.X$"X......X$$$X|
|D..X.$$XXXT.....G"X.......$$$X|
|XXX"X"X"X"X"X"X"X"XXXXXXXXXXXX|
+------------------------------+
|XXXXXXXXXXXXXXXXXXXXXXXXXXXXXX|
|X........."....-......"......X|
|X.........."....-....".......X|
|X..........."....-...........X|
|X..............-...".........X|
|X....X.X......"..-"..........X|
|X.....X........"."...X.X.....X|
|X....X.X......."."....X......X|
|X$$X..........."."...X.X.....X|
|X$$X..........."."...........X|
|X$$X..........."."...........X|
|X"""""""======="."=======""""X|
|X""""""".......".".......""""X|
|X""""""".......".".......""""X|
|X"""""""....M.."."..M....""""X|
|X""""""".......".".......""""X|
|X..G..."......."."......."...X|
|X...G..".......".".......".d.X|
|X....G.".$.....".".....$."...X|
|X."...."$.$...."!"....$.$"...X|
|X."===="""""""""."""""""""...X|
|X."...."""""""""."""""""""===X|
|X."G...=........-........=...X|
|X.".G..=......-..........=...X|
|X."..G.=......-..........=...X|
|X."....=......-..........=...X|
|XDXXXXXXXXXXXXXXXXXXXXXXXXXXXX|
+------------------------------+
