+-----------+
|XXXXXXXXXXX|
|X....$....X|
|X.".....".X|
|X.G"..."G.X|
|X..G"."G..X|
|X..$."_...X|
|X..."."G..X|
|X.."G.."G.X|
|X$"G....".X|
|X"....$...X|
|XXDXXXXXXXX|
+-----------+
|XXXXXXXXXXX|
|X....$....X|
|X.".....".X|
|X.-"..."-.X|
|X..!"."!..X|
|X..$."_...X|
|X..."."!..X|
|X.."!.."-.X|
|X$"-....".X|
|X"....$...X|
|XXDXXXXXXXX|
+-----------+
|XXXXXXXXXXX|
|X...GX...GX|
|XG...X!...X|
|X....X...pX|
|X....X.XXXX|
|X........-X|
|XXDXXXXXXXX|
+-----------+
|XXXDXXXXXXX|
|X...GX...GX|
|XG...X!...X|
|X....X...pX|
|X....X.XXXX|
|X........-X|
|XXDXXXXXXXX|
+-----------+
|XXXDXXXXXXX|
|X...GX.p.GX|
|XG...X!...X|
|X....X...pX|
|X...GX.XXXX|
|X........-X|
|XG.......-X|
|X........-X|
|XXDXXXXXXXX|
+-----------+
|XXXDXXXXXXX|
|X...GX..p.X|
|XG...X!...X|
|X....X...pX|
|X...GX.!XXX|
|X........-X|
|XG...X...-X|
|X........-X|
|XXDXXXXXXXX|
+-----------+
|XXXDXXXXXXX|
|X...sX..p.X|
|Xs...X!...X|
|X..s.X...pX|
|X...sX.!XXX|
|X.s......-X|
|Xs...X...-X|
|X.....s..-X|
|XXDXXXXXXXX|
+-----------+
