+-------------------------------+
|                    XXXXXXXXXXX|
|                    XTXX.....$X|
|                    XXXX......X|
|                    XXXX......X|
|                    X.........X|
|                    X.....X...X|
|                    X.........X|
|                    X.........X|
|                   X..X.......X|
|XXXXXXXXXXXXXXXXXXX...........X|
|D............... .G.......d...X|
|XXXXXXXXXXXXXXXXXXX...........X|
|                   X...X......X|
|                    X.........X|
|                    X.........X|
|                    X......X..X|
|                    X.....X.X.X|
|                    X..X..X...X|
|                    X...X.X$$$X|
|                    X....X.$$$X|
|                    X..X...$$$X|
|                    XXXXXXXXXXX|
+-------------------------------+
|                    XXXXXXXXXXX|
|                    XTXX.....$X|
|                    XXXX......X|
|                    XXXX......X|
|                    X.........X|
|                    X.....X...X|
|                    X.........X|
|          XXXX      X.........X|
|          XppX     X..X.......X|
|XXXXXXXXXXXX XXXXXX...........X|
|D.................G.......d...X|
|XXXXXXXXXXX XXXXXXX...........X|
|          XppX     X...X......X|
|          XXXX      X.........X|
|                    X.........X|
|                    X......X..X|
|                    X.....X.X.X|
|                    X..X..X...X|
|                    X...X.X$$$X|
|                    X....X.$$$X|
|                    X..X...$$$X|
|                    XXXXXXXXXXX|
+-------------------------------+
|                    XXXXXXXXXXX|
|                    XTXX.....$X|
|          XXXXX     XXXX......X|
|          X$$$X     XXXX......X|
|          X$$$X     X.........X|
|          X$$$X     X.....X...X|
|          X.XXX     X.........X|
|          X.X       X.........X|
|          X.X      X..X.......X|
|XXXXXXXXXXX XXXXXXX...........X|
|D.................G.......d...X|
|XXXXXXXXXXXXXXXXXXX...........X|
|                   X...X......X|
|                    X.........X|
|                    X.........X|
|                    X......X..X|
|                    X.....X.X.X|
|                    X..X..X...X|
|                    X...X.X$$$X|
|                    X....X.$$$X|
|                    X..X...$$$X|
|                    XXXXXXXXXXX|
+-------------------------------+
|                    XXXXXXXXXXX|
|                    XT.X.....$X|
|                    X.dX......X|
|                    XXXX......X|
|                    X.........X|
|                    X.....X...X|
|                    X.........X|
|          XXXX      X.........X|
|          XppX     X..X.......X|
|XXXXXXXXXXX  XXXXXX...........X|
|D.................G.......d...X|
|XXXXXXXXXXXXXXXXXXX...........X|
|          XppX     X...X......X|
|          XXXX      X.........X|
|                    X.........X|
|                    X......X..X|
|                    X.....X.X.X|
|                    X..X..X...X|
|                    X...X.X$$$X|
|                    X....X.$$$X|
|                    X..X...$$$X|
|                    XXXXXXXXXXX|
+-------------------------------+
