+-------------------------------+
|XXXXXXXXXXXXXXXXXXXXXXXXXXXXXXX|
|X........................=$$$$X|
|X........................=$$$$X|
|X........................=$$$$X|
|X........................=$$$$X|
|X........................=====X|
|X.............................X|
|X.............................X|
|X.............................X|
|X.............................X|
|X.............................X|
|X.............................X|
|X.............................X|
|X.............................X|
|X.............d...............X|
|X.............................X|
|X.............................X|
|X.............................X|
|X.............................X|
|X.............................X|
|X.............................X|
|X.............................X|
|X.............................X|
|X.............................X|
|X.............................X|
|X.............................X|
|X.............................X|
|X.............................X|
|XDXXXXXXXXXXXXXXXXXXXXXXXXXXXXX|
+-------------------------------+
|XXXXXXXXXXXXXXXXXXXXXXXXXXXXXXX|
|X........................X$$$$X|
|X........................X$$$$X|
|X........................X$$$$X|
|X........................X$$$$X|
|X........................XXXX=X|
|X.............................X|
|X.............................X|
|X.............................X|
|X.............................X|
|X.............................X|
|X.............................X|
|X.............................X|
|X.............................X|
|X.............d...............X|
|X.............................X|
|X.............................X|
|X.............................X|
|X.............................X|
|X.............................X|
|X.............................X|
|X.............................X|
|X.............................X|
|X.............................X|
|X.............................X|
|X.............................X|
|X.............................X|
|X.............................X|
|XDXXXXXXXXXXXXXXXXXXXXXXXXXXXXX|
+-------------------------------+
|XXXXXXXXXXXXXXXXXXXXXXXXXXXXXXX|
|X........................XT$$$X|
|X........................X$$$$X|
|X........................X$$d$X|
|X........................X$$$$X|
|X........................XXXX=X|
|X.............................X|
|X.............................X|
|X.............................X|
|X.............................X|
|X.............................X|
|X.............................X|
|X.............................X|
|X.............................X|
|X.............................X|
|X.............................X|
|X.............................X|
|X.............................X|
|X.............................X|
|X.............................X|
|X.............................X|
|X.............................X|
|X.............................X|
|X.............................X|
|X.............................X|
|X.............................X|
|X...T.........................X|
|X.............................X|
|XDXXXXXXXXXXXXXXXXXXXXXXXXXXXXX|
+-------------------------------+
|XXXXXXXXXXXXXXXXXXXXXXXXXXXXXXX|
|X.............XX..............X|
|XT............XX..............X|
|X..........d..XX...T..........X|
|X.............XX..............X|
|X$$$$$........XX..............X|
|X$$$$$........XX..............X|
|XXXXXXXXXXXXXXXXXXXXXXXXXXXXXXX|
|XXXXXXXXXXXXXXXXXXXXXXXXXXXXXXX|
|X.............XX..............X|
|X.............XX..............X|
|X.............XX..............X|
|X........T....XX..............X|
|X.............XX............T.X|
|X.............XX..............X|
|X.............XX..............X|
|X.............XX..............X|
|XXXXXXXXXXXXXXXXXXXXXXXXXXXXXXX|
|XXXXXXXXXXXXXXXXXXXXXXXXXXXXXXX|
|X.............XX..............X|
|X.............XX.........M....X|
|X.............XX..............X|
|X....T........XX..............X|
|X.............XX..............X|
|X.............XX......T.......X|
|X.............XX..............X|
|X.............XX..............X|
|X.............XX..............X|
|XXXXXXXXXXXXXXXXXXXXXXXXXXXXXXX|
|XXXXXXXXXXXXXXXXXXXXXXXXXXXXXXX|
|X.............XX..............X|
|X.............XX..............X|
|X.............XX..............X|
|X.............XX..............X|
|X.............XX..............X|
|X...T.........XX.........T....X|
|X.............XX..............X|
|XDXXXXXXXXXXXXXXXXXXXXXXXXXXXXX|
+-------------------------------+
|XXXXXXXXXXXXXXXXXXXXXXXXXXXXXXX|
|X.............XX..............X|
|XT............XX.......$$$$...X|
|X..........d..XX...T...$$$$...X|
|X.............XX.......$$$$...X|
|X$$$$$........XX.......$$$$...X|
|X$$$$$........XX..............X|
|XXXXXXXXXXXXXXXXXXXXXXXXXXXXXXX|
|XXXXXXXXXXXXXXXXXXXXXXXXXXXXXXX|
|X.............XX..............X|
|X.............XX..............X|
|X.............XX..............X|
|X........T....XX..............X|
|X.............XX............T.X|
|X.............XX..............X|
|X.............XX..............X|
|X.............XX..............X|
|XXXXXXXXXXXXXXXXXXXXXXXXXXXXXXX|
|XXXXXXXXXXXXXXXXXXXXXXXXXXXXXXX|
|X.............XX..............X|
|X.............XX.........M....X|
|X.............XX..............X|
|X....T........XX..............X|
|X.............XX..............X|
|X.............XX......T.......X|
|X.............XX..............X|
|X....M........XX..............X|
|X.............XX..............X|
|XXXXXXXXXXXXXXXXXXXXXXXXXXXXXXX|
|XXXXXXXXXXXXXXXXXXXXXXXXXXXXXXX|
|X.............XX..............X|
|X.............XX..............X|
|X.............XX...M..........X|
|X.............XX..............X|
|X.............XX..............X|
|X...T.........XX.........T....X|
|X.............XX..............X|
|XDXXXXXXXXXXXXXXXXXXXXXXXXXXXXX|
+-------------------------------+
