+-----------+
|XXXXXXXXXXX|
|X..C.C.C..X|
|XC.......CX|
|X...._....X|
|XC.......CX|
|X.........X|
|XC.......CX|
|X..C.C.C..X|
|XXXXXXXXXXX|
+-----------+
|LLLLLLLLLLL|
|LL.C.C.C.LL|
|LC.......CL|
|L...._....L|
|LC.......CL|
|L.........L|
|LC.......CL|
|LL.C.C.C.LL|
|LLLLLLLLLLL|
+-----------+
|XXXXXXXXXXX|
|X..s.s.s..X|
|Xs.......sX|
|X...._....X|
|Xs.......sX|
|X.........X|
|Xs.......sX|
|X..s.s.s..X|
|XXXXXXXXXXX|
+-----------+
|LLLLLLLLLLL|
|LL.s.s.s.LL|
|Ls.......sL|
|L...._....L|
|Ls.......sL|
|L.........L|
|Ls.......sL|
|LL.s.s.s.LL|
|LLLLLLLLLLL|
+-----------+
|XXXXXXXXXXX|
|X..o.o.o..X|
|Xo.......oX|
|X...._....X|
|Xo.......oX|
|X.........X|
|Xo.......oX|
|X..o.o.o..X|
|XXXXXXXXXXX|
+-----------+
|LLLLLLLLLLL|
|LL.o.o.o.LL|
|Lo.......oL|
|L...._....L|
|Lo.......oL|
|L.........L|
|Lo.......oL|
|LL.o.o.o.LL|
|LLLLLLLLLLL|
+-----------+
|XXXXXXXXXXX|
|X..g.g.g..X|
|Xg.......gX|
|X...._....X|
|Xg.......gX|
|X.........X|
|Xg.......gX|
|X..g.g.g..X|
|XXXXXXXXXXX|
+-----------+
|LLLLLLLLLLL|
|LL.g.g.g.LL|
|Lg.......gL|
|L...._....L|
|Lg.......gL|
|L.........L|
|Lg.......gL|
|LL.g.g.g.LL|
|LLLLLLLLLLL|
+-----------+
