+------------+
|XXXXXXXXXXXX|
|XG,........X|
|X.XXXXXXXX.X|
|X.XXXXXXXX.X|
|X...XX.....X|
|X..XX.....GX|
|X.XXG......X|
|X.XXX......X|
|X..XXX.....X|
|X...XXX....X|
|X....XXX...X|
|X$.$.GXXX..X|
|X.$..GXXX..X|
|X$.$.GXXX..X|
|XXXXXXXXXX.X|
|XXXXXXXXXX.X|
|X...G...G..X|
|X.....G...GX|
|XXDXXXXXXXXX|
+------------+
|XXXXXXXXXXXX|
|XG,........X|
|X.XXXXXXXX.X|
|X.XXXXXXXX.X|
|X...XXX....X|
|X....XXX...X|
|X$.$.GXXX..X|
|X.$..GXXX..X|
|X$.$.GXXX..X|
|XXXXXXXXXX.X|
|XXXXXXXXXX.X|
|X...G...G..X|
|X...XX.....X|
|X..XX.....GX|
|X.XXG......X|
|X.XXX......X|
|X..XXX.....X|
|X.....G...GX|
|XXDXXXXXXXXX|
+------------+
|XXXXXXXXXXXX|
|XG,........X|
|X.XXXXXXXX.X|
|X.XXXXXXXX.X|
|X...XXX....X|
|X...G...G..X|
|X...XX.....X|
|X..XX.....GX|
|X....XXX...X|
|X$.$.GXXX..X|
|X.$..GXXX..X|
|X$.$.GXXX..X|
|XXXXXXXXXX.X|
|XXXXXXXXXX.X|
|X.XXG......X|
|X.XXX......X|
|X..XXX.....X|
|X.....G...GX|
|XXDXXXXXXXXX|
+------------+
|XXXXXXXXXXXX|
|XG,........X|
|X.XXXXXXXX.X|
|X...XXX....X|
|X...G...G..X|
|X...XX.....X|
|X..XX.....GX|
|X....XXX...X|
|X$.$.GXXX..X|
|X.$..GXXX..X|
|X$.$.GXXX..X|
|X.XXXXXXXX.X|
|X.XXG......X|
|X.XXX......X|
|X..XXX.....X|
|XXXXXXXXXX.X|
|XXXXXXXXXX.X|
|X.....G...GX|
|XXDXXXXXXXXX|
+------------+
