+--------+
|XXXXXXXX|
|XiXiXiXX|
|X.....iX|
|X..K..XX|
|D.....iX|
|D..iXiXX|
|XDDXXXXX|
+--------+
|XXXXXXXX|
|D.i..i.D|
|D......D|
|X......X|
|Xi....iX|
|X..K...X|
|D......D|
|D.i..i.D|
|XXXXXXXX|
+--------+
