+--------+
|XXXXXXXX|
|XXXiXiXX|
|XX....iX|
|Xi.K..XX|
|XX....iX|
|Xi....XX|
|X...iXXX|
|XXDXXXXX|
+--------+
|XXXXXXXX|
|X..i.i.X|
|X.....iX|
|Xi.K...X|
|X.....iX|
|Xi.....X|
|X...i..X|
|XXDXXXXX|
+--------+
|XXXXXXXX|
|XXXiXiXX|
|XX....iX|
|Xi.K..XX|
|XX....iX|
|Xi....XX|
|X...iXXX|
|XXDXXXXX|
+--------+
|XXXXXXXX|
|X..i.i.X|
|X.....iX|
|Xi.K...X|
|X.....iX|
|Xi.....X|
|X.....iX|
|Xi.....X|
|X...i..X|
|XDDDXXXX|
+--------+
|XXXXXXXX|
|X......X|
|X.i.i..X|
|X......X|
|X..i.i.X|
|X......X|
|X..K...X|
|XDDDXXXX|
+--------+
|XXXXXXXX|
|X......X|
|X.i..i.X|
|X......X|
|X.i..i.X|
|X......X|
|X..K...X|
|XDDDXXXX|
+--------+
