+--------+
|  XDDX  |
|  X..X  |
|  X..X  |
| XX..XX |
|XX....XX|
|Xi.K..iX|
|XX....XX|
|Xi.ii.iX|
|XX....XX|
|Xi.ii.iX|
|XXXXXXXX|
+--------+
|XXXXXXXX|
|XX....XX|
|Xi.K..iX|
|XX....XX|
|Xi.ii.iX|
|XX....XX|
|Xi....iX|
| XX..XX |
|  X..X  |
|  X..X  |
| XX..XX |
|  XDDX  |
+--------+
|  XDDX  |
|  X..X  |
|  X..X  |
| XX..XX |
|XX....XX|
|Xi.K..iX|
|X......X|
|Xi.ii.iX|
|X......X|
|Xi....iX|
| XX..XX |
|  X..X  |
|  X..X  |
| XX..XX |
|  XDDX  |
+--------+
