+--------+
|XXXXDDXX|
|XXXX..XX|
|XX....XX|
|XX.....X|
|X......X|
|X......X|
|Xi.K..iX|
|XX....XX|
|Xi....iX|
|XX....XX|
|Xi....iX|
|XX....XX|
|Xi....iX|
|XXiXXiXX|
|XXXXXXXX|
+--------+
