+-----------+
|XXXXXXXXXXX|
|XXXXXXXXXXX|
|XX.......XX|
|XX.$.$.$.XX|
|XX.......XX|
|XX.$.$.$.XX|
|XX.......XX|
|XX.$.$.$.XX|
|XX.......XX|
|XXXXXXXXXXX|
|XXXXXXXXXXX|
|XXXXAAAXXXX|
|XXXXA.AXXXX|
|XXXXX.XXXXX|
|XXAXA.AXXXX|
|X......AXXX|
|X....K.XXXX|
|X......AXXX|
|X......XXXX|
|X......AXXX|
|X...AXAXXXX|
|XDDDXXXXXXX|
+-----------+
|XDDDXXXXXXX|
|XX....AXXXX|
|XXXX..XXXXX|
|XXAX..AXXXX|
|X......AXXX|
|X....K.XXXX|
|X......AXXX|
|X......XXXX|
|X......AXXX|
|X...AXAXXXX|
|XXXXXXXXXXX|
|XXXXXXXXXXX|
|XX.......XX|
|XX.$.$.$.XX|
|XX.......XX|
|XX.$.$.$.XX|
|XX.......XX|
|XX.$.$.$.XX|
|XX.......XX|
|XXXXXXXXXXX|
+-----------+
