+-----------+
|XXXXXXXXXXX|
|X!.......-X|
|XXXXXXXXX.X|
|XA.A..A.X.X|
|X.......X.X|
|XA.A.K..X!X|
|X.......X$X|
|XA.A....X$X|
|X.......XXX|
|X.......XXX|
|XDXXXXXXXXX|
+-----------+
