+--------+
|XXXXXXXX|
|XIIIIIIX|
|XI....IX|
|X..K..IX|
|X.....IX|
|X..IIIIX|
|XXDXXXXX|
+--------+
|XXXXXXXX|
|XIIIIIIX|
|XI.....D|
|XI.K..IX|
|XI....IX|
|XI.IIIIX|
|XXDXXXXX|
+--------+
|XXXXXXXX|
|XIIIIIIX|
|XI....IX|
|D..K..IX|
|X.....IX|
|X..IIIIX|
|XXDXXXXX|
+--------+
|XXDXXXXX|
|XI.IIIIX|
|XI....IX|
|XI.K..IX|
|XI....IX|
|XIIIIIIX|
|XXXXXXXX|
+--------+
|XXXXXXXX|
|XIIIIIIX|
|XI....IX|
|D..K..IX|
|D.....IX|
|D..IIIIX|
|XXXXXXXX|
+--------+
|XXXXXXXX|
|XIIIIIIX|
|XI.....D|
|XI.K..IX|
|XI....IX|
|XI...IIX|
|XXDDDXXX|
+--------+
|XXXXXXXX|
|XIIIIIIX|
|XI.....D|
|X..K...D|
|XI.....D|
|XIIIIIIX|
|XXXXXXXX|
+--------+
|XXDDDXXX|
|XI...IIX|
|XI....IX|
|XI.K..IX|
|XI....IX|
|XIIIIIIX|
|XXXXXXXX|
+--------+
