+-------------------------------+
|       XXXXXXXXXXXXXXXXX       |
|     XXX...............XXX     |
|   XX.....................XX   |
|  Xccc......................X  |
| Xpc$c...X........X..........X |
|XXc$c....................XX..XX|
|Xccc.....d....................X|
|X$c.........X............XXX..X|
|X......X...................X..X|
|XX..................X......X.XX|
| X.........................X.X |
|  X........................XD  |
|   XX.....X......XDXXXXX..XX   |
|     XXX.........Xd..._XXX     |
|       XXXXXXXXXXXXXXXXX       |
+-------------------------------+
|       XXXXXXXXXXXXXXXXX       |
|     XXX...XccccX......XXX     |
|   XX......XccdcX.........XX   |
|  Xccc.....XccccX...........X  |
| Xpc$c...X.XXXDXX.X..........X |
|XXc$c....................XX..XX|
|Xccc.....d....................X|
|X$c.........X............XXX..X|
|X......X...................X..X|
|XX..................X......X.XX|
| X.........................X.X |
|  X........................XD  |
|   XX.....X......XDXXXXX..XX   |
|     XXX.........Xd..._XXX     |
|       XXXXXXXXXXXXXXXXX       |
+-------------------------------+
|       XXXXXXXXXXXXXXXXX       |
|     XXX...X$$$$X......XXX     |
|   XX......X$$$$X...d.....XX   |
|  Xcpc.....X$$$$X.....X.....X  |
| Xpc$c...X.XXXDXX.XXXXX......X |
|XXp$c........X.X..X...X..XX..XX|
|Xpccc....d.....X..X...........X|
|X$cpc.......X.........X..XXX..X|
|Xppc...X..............X....X..X|
|XXpcc.......XXXX.d.XXXX....X.XX|
| Xpc...........X.X.X.......X.X |
|  X............X.X.X.......XD  |
|   XX.....X......XDXXXXX..XX   |
|     XXX.........Xd.pp_XXX     |
|       XXXXXXXXXXXXXXXXX       |
+-------------------------------+
|       XXXXXXXXXXXXXXXXX       |
|     XXX.........pX....XXX     |
|   XX.............X.......XX   |
|  Xccc.......X....X.........X  |
| Xpc$c...X........X..........X |
|XXc$c.............X......XX..XX|
|Xccc.....d........X...........X|
|X$c.......X.X............XXX..X|
|X......X.XXX...............X..X|
|XX........X.X...XXXXX......X.XX|
| X..............X.X.X......X.X |
|  X.......X................XD  |
|   XX.....X......XDXXXXX..XX   |
|     XXX.........Xd..._XXX     |
|       XXXXXXXXXXXXXXXXX       |
+-------------------------------+
|       XXXXXXXXXXXXXXXXX       |
|     XXX...XccccX......XXX     |
|   XX......XccdcX.........XX   |
|  Xccc.....XccccX...........X  |
| Xpc$c...X.XXXDXX.XXXXXXXX.GpX |
|XXc$c...........X........XXXXXX|
|Xccc.....d......X...X.........X|
|X$c........XXXX.X...X....XXX..X|
|X......X......X.....X......X..X|
|XX..................X......X.XX|
| X.........................X.X |
|  X........................XD  |
|   XX.....X......XDXXXXX..XX   |
|     XXX.........Xd..._XXX     |
|       XXXXXXXXXXXXXXXXX       |
+-------------------------------+
|       XXXXXXXXXXXXXXXXX       |
|     XXX...X$$$$X......XXX     |
|   XX......X$$$$X...d.....XX   |
|  Xcpc.....X$$$$X.....X.....X  |
| Xpc$c...X.XXXDXX.XXXXX......X |
|XXp$c........X.X..X...X..XX..XX|
|Xpccc....d.....X..X...........X|
|X$cpc......XX.........X..XXX..X|
|Xppc...X....X.........X....X..X|
|XXpcc..X....XXXX.d.XXXX....X.XX|
| Xpc...X.......X.X.X.......X.X |
|  X....X.XXX...X.X.X.......XD  |
|   XX.XX..X......XDXXXXX..XX   |
|     XXX.........Xd.pp_XXX     |
|       XXXXXXXXXXXXXXXXX       |
+-------------------------------+
