+-------------------------------+
|       XXXXXXXXXXXXXXXXX       |
|     XXX.......=.=....GXXX     |
|   XX$XX.......XXX........XX   |
|  X$$$XX...M...X$X......M...X  |
| XXXXXXX.......X$X..M........X |
|XXXXXXXXXXXXXX=X$X...........XX|
|XXXXXXXXXXXXXX.X$X...........XX|
|XXXXXX$$$$$XXX=X$X...........XX|
|XXXXXX$$$$$XXX.X$X...........XX|
|XXXXXXXXXXXXXX=X$X...........XX|
|XXXXXXXXXXXXXX.X$XXXXXXXXXX==XX|
|X...XXXXXXXXXX=XXXXXXXXXXXX==XX|
|D...XXXXXXXXXX.XXXXX$$$$XXX==XX|
|X...XXXXXXXXXX=XXXXXXXXXXXX==XX|
|XX..X.....M..X.XXXX..........XX|
| X..=........X=X$XX...d......X |
|  X.=........X.X$XX........XX  |
|  X.=........X=X$XX........XX  |
|  X.=..........X$XX........XX  |
|  X.=........XXX$XX........XX  |
|  X.=........XXX$XX........XX  |
|  X.=........XXX$XX........XX  |
|  X.=........XXX$XX$$$$$$$$XX  |
|   XX........XXX$XX$$$$$$$XX   |
|     XXX.....XXXXXX$$$$XXX     |
|       XXXXXXXXXXXXXXXXX       |
+-------------------------------+
