+-------------------------------+
|       XXXXXXXXXXXXXXXXX       |
|     XXXXXX...........GXXX     |
|   XX.GXXXX.X"X"XX........XX   |
|  X%...XXXX...-.............X  |
| X..XX.XX...."XX.............X |
|  X.XX.X.....XXXXXX....."XXXXX |
|XXX..X......."XXXXX...."G..XXX |
|D............XXXXXX..."G...XXX |
|XXXXX"X"X"XXXXXXXXX.."G...$XX  |
|  XXX.XXXX.G......XXXX..m$$XX  |
|  XXX..XX..G.XXXX.XXXX-XXXXXX  |
|   XX......G.XXXX....X-XXXXX   |
|   XX.X.XX.GXXXXXXXX.X-XXXX    |
|   XX.XXXXXXXX...XXX.X=XXXX    |
|   XX...XXXXX..d.XXX!X....X    |
|   XX!....XXX....XXX.X.M..X    |
|   XX...XX.......XXX.X....XX   |
|   XX..XXXXX.....XXX....XXXX   |
|     XXX$$$X.....XXXXXXXXXXXX  |
|       XXXXXXXXXXXXXXXXX       |
+-------------------------------+
