+------+
|XXXXXX|
|X...pX|
|X.pm.X|
|X....D|
|Xpm..X|
|XXXXXX|
+------+
|XXXDXX|
|X.pm.X|
|X...mX|
|X.pm.X|
|X...mX|
|XXXXXX|
+------+
|XXXXXX|
|X.m..X|
|D...pX|
|X.pm.X|
|X...mX|
|XXXXXX|
+------+
|XXXXXX|
|Xpm..X|
|X...mX|
|X.pm.X|
|X...pX|
|XXDXXX|
+------+
|XXDXXX|
|X...pX|
|X.pm.X|
|X...mD|
|Xpm..X|
|XXXXXX|
+------+
|XXXDXX|
|X.pm.X|
|X...mX|
|X.pm.X|
|X...mX|
|XXXDXX|
+------+
|XXXXXX|
|Xpm..X|
|Dm..pX|
|Dmpm.X|
|X...mX|
|XXXXXX|
+------+
|XXDDXX|
|Xpm..X|
|X...mX|
|X.pm.X|
|X...pX|
|XXDXXX|
+------+
|XXXXXX|
|X...pX|
|X.pm.X|
|X...mD|
|Xpm..X|
|XXXXXX|
+------+
|XDDDDX|
|X.pm.X|
|X...mX|
|X.pm.X|
|X...mX|
|XXXXXX|
+------+
|XXXXXX|
|Dpm..X|
|Dm..pX|
|Dmpm.X|
|Dm..mX|
|XXXXXX|
+------+
|XXXXXX|
|Xpm..X|
|X...mX|
|X.pm.X|
|X...pX|
|XXDXXX|
+------+
|XDDDDX|
|X...pX|
|X.pm.D|
|X...mD|
|Xpm..X|
|XXDDXX|
+------+
|XXXXXX|
|X.pm.X|
|X...mD|
|X.pm.D|
|X...mX|
|XXXXXX|
+------+
|XXDDXX|
|Xpm..X|
|Dm..pD|
|Dmpm.D|
|X...mX|
|XXDDXX|
+------+
|XDXXXX|
|Dpm..X|
|X...mX|
|X.pm.X|
|X...pD|
|XXXXDX|
+------+
|XXXXXX|
|X...pX|
|X.pm.X|
|X...m=|
|Xpm..X|
|XXXXXX|
+------+
|XXX=XX|
|X.pm.X|
|X...mX|
|X.pm.X|
|X...mX|
|XXXXXX|
+------+
|XXXXXX|
|Xpm..X|
|=...pX|
|X.pm.X|
|X...mX|
|XXXXXX|
+------+
|XXXXXX|
|Xpm..X|
|X...mX|
|X.pm.X|
|X...pX|
|XX=XXX|
+------+
|XX=XXX|
|X...pX|
|X.pm.X|
|X...m=|
|Xpm..X|
|XXXXXX|
+------+
|XXX=XX|
|X.pm.X|
|X...mX|
|X.pm.X|
|X...mX|
|XXX=XX|
+------+
|XXXXXX|
|Xpm..X|
|=...pX|
|=.pm.X|
|X...mX|
|XXXXXX|
+------+
|XX==XX|
|Xpm..X|
|X...mX|
|X.pm.X|
|X...pX|
|XX=XXX|
+------+
|XXXXXX|
|X...pX|
|X.pm.X|
|X...m=|
|Xpm..X|
|XXXXXX|
+------+
|X====X|
|X.pm.X|
|X...mX|
|X.pm.X|
|X...mX|
|XXXXXX|
+------+
|XXXXXX|
|=pm..X|
|=...pX|
|=.pm.X|
|=...mX|
|XXXXXX|
+------+
|XXXXXX|
|Xpm..X|
|X...mX|
|X.pm.X|
|X...pX|
|XX=XXX|
+------+
|X====X|
|X...pX|
|X.pm.=|
|X...m=|
|Xpm..X|
|XX==XX|
+------+
|XXXXXX|
|X.pm.X|
|X...m=|
|X.pm.=|
|X...mX|
|XXXXXX|
+------+
|XX==XX|
|=pm..=|
|=...p=|
|=.pm.=|
|=...m=|
|X====X|
+------+
|X=XXXX|
|=pm..X|
|X...mX|
|X.pm.X|
|X...p=|
|XXXX=X|
+------+
