+------------+
|XXXXXXXXXXXX|
|XGdp$m.$.pGX|
|Xm.m.m.m$.pX|
|X.m.$.m...$X|
|X.$..m.m.$.X|
|XG..m....mGX|
|X====DD====X|
+------------+
|XXXXXXXXXXXX|
|XG.p$__$.pGX|
|Xm.m.m.m$.pX|
|X.m.$.m...$X|
|X.$..m.m.$.X|
|XG..m....mGX|
|X==========X|
+------------+
|XXXXXXXXXXXX|
|XG.p$__$.pGX|
|Xm.m.m.m$.pX|
|X.m.$.m...$X|
|X.$..m.m.$.X|
|XG..m....mGX|
|XXXXX==XXXXX|
|    X==X    |
|    X==X    |
|    X==X    |
|    X==X    |
|    XDDX    |
+------------+
|XXXXXXXXXXXX|
|X..........X|
|X.========.X|
|X.=......=.X|
|X.=......=.X|
|X.=..G_..=.X|
|X.=......=.X|
|X.=......=.X|
|X.========.X|
|X..........X|
|XXXXX..XXXXX|
|    X..X    |
|    X..X    |
|    X..X    |
|    X..X    |
|    XDDX    |
+------------+
|XXXXXXXXXXXX|
|X..........X|
|X.========.X|
|X.=.$..$.=.X|
|X.=......=.X|
|X.=..G_..=.X|
|X.=.$..$.=.X|
|X.=..$...=.X|
|X.========.X|
|X..........X|
|XXXXX..XXXXX|
|    X..X    |
|    X..X    |
|    X..X    |
|    X..X    |
|    XDDX    |
+------------+
|XXXXXXXXXXXX|
|X..........X|
|X.========.X|
|X.=G$p.$G=.X|
|X.=.....p=.X|
|X.=p.G_..=.X|
|X.=.$..$.=.X|
|X.=G.$..G=.X|
|X.========.X|
|X..........X|
|XXXXX..XXXXX|
|    X..X    |
|    X..X    |
|    X..X    |
|    X..X    |
|    XDDX    |
+------------+
|XXXXXXXXXXXX|
|X..........X|
|X.========.X|
|X.=......=.X|
|X.=......=.X|
|X.=..d_..=.X|
|X.=......=.X|
|X.=......=.X|
|X.========.X|
|X..........X|
|XXXXX..XXXXX|
|    X..X    |
|    X..X    |
|    X..X    |
|    X..X    |
|    XDDX    |
+------------+
|XXXXXXXXXXXX|
|X..........X|
|X.========.X|
|X.=.$..$.=.X|
|X.=......=.X|
|X.=..d_..=.X|
|X.=.$..$.=.X|
|X.=..$...=.X|
|X.========.X|
|X..........X|
|XXXXX..XXXXX|
|    X..X    |
|    X..X    |
|    X..X    |
|    X..X    |
|    XDDX    |
+------------+
|XXXXXXXXXXXX|
|X..........X|
|X.========.X|
|X.=d$p.$d=.X|
|X.=.....p=.X|
|X.=p.._..=.X|
|X.=.$..$.=.X|
|X.=d.$..d=.X|
|X.========.X|
|X..........X|
|XXXXX..XXXXX|
|    X..X    |
|    X..X    |
|    X..X    |
|    X..X    |
|    XDDX    |
+------------+
