+-----------------+
|XXXXXXXXDXXXXXXXX|
|Xm...._X.X....m.X|
|X..p..mX.X.pG...X|
|X..G...X!X.m..._X|
|XXXXXXXX.XXXXXXXX|
|XXX!pppX.Xpp.XXXX|
|XXX.XXXX.XXX!XXXX|
|XXX.XXXX.XXX.XXXX|
|D.=......-....=.D|
|D.=....-......=.D|
|D.=........-..=.D|
|XXXX!XXX.XX.XXXXX|
|XXXX.XXX.XX!XXXXX|
|XXXX.pXX.XX.pXXXX|
|XXXXXXXX!XXXXXXXX|
|Xp.$m..X.X_.m...X|
|Xmpm.$mX.X..pG..X|
|X_m.$.$X.X......D|
|XXXXXXXXDXXXXXXXX|
+-----------------+
|XXXXXXXXDXXXXXXXX|
|Xm...._X.X....m.X|
|X..p..mX.X..mp..X|
|X..m...X.X.m..._X|
|XXXXXXXX!XXXXXXXX|
|XXX.X.pX.XXp.X.XX|
|XXX!X!XX.XXX!X.XX|
|XXX.X.XX.XXX.X!XX|
|D...............D|
|D...............D|
|D.............!.D|
|XXX!X.XX.XXX.X.XX|
|XXX.X!XX.XXX!X.XX|
|XXX.X.pX.XXp.X.XX|
|XXXXXXXX.XXXXXXXX|
|Xp.$m..X!X_.m...X|
|Xmpm.$mX.X...m..X|
|X_m.$.$X.X......D|
|XXXXXXXXDXXXXXXXX|
+-----------------+
