+------------+
|XXXXXXXXXXXX|
|XXXXXXXXXXXX|
|XXXXXXXXXXXX|
|XXXXX$$XXXXX|
|XXXXX$$XXXXX|
|XX$$$$$$$$XX|
|XX$$$$$$$$XX|
|XXXXX$$XXXXX|
|XXXXX$$XXXXX|
|XXXXXXXXXXXX|
|XXXXXXXXXXXX|
|XXXXXXXXXXXX|
+------------+
