+--------------------+
|XXXXXXXXXXXXXXXXXXXX|
|X%$$$X.......X.m...X|
|X%$$$X.......X.....D|
|X%$$$X..M..X.D..m..D|
|X%$$$X.......X.....D|
|X%$$$X.......X.m...X|
|XXXXXXXXXXXXXXXXXXXX|
+--------------------+
|XXXXXXXXXXXXXXXXXXXX|
|X%$$$X.......X.m...X|
|X%$$$X.......X.....X|
|X%$$$X..M..X.D..m..X|
|X%$$$X.......X.....X|
|X%$$$X.......X.m...X|
|XXXXXXXXXXXXXXXDDDXX|
+--------------------+
|XXXXXXXXXXXXXXXDDDXX|
|X%$$$X.......X.m...X|
|X%$$$X.......X.....X|
|X%$$$X..M..X.D..m..X|
|X%$$$X.......X.....X|
|X%$$$X.......X.m...X|
|XXXXXXXXXXXXXXXXXXXX|
+--------------------+
|XXXXXXXXXXXXXXXXXXXX|
|X%$$$X.......=.m...X|
|X%$$$X.......=.....D|
|X%$$$X..M..X.=..m..D|
|X%$$$X.......=.....D|
|X%$$$X.......=.m...X|
|XXXXXXXXXXXXXXXXXXXX|
+--------------------+
|XXXXXXXXXXXXXXXXXXXX|
|X%$$$X.......=.m...X|
|X%$$$X.......=.....X|
|X%$$$X..M..X.=..m..X|
|X%$$$X.......=.....X|
|X%$$$X.......=.m...X|
|XXXXXXXXXXXXXXXDDDXX|
+--------------------+
|XXXXXXXXXXXXXXXDDDXX|
|X%$$$X.......=.m...X|
|X%$$$X.......=.....X|
|X%$$$X..d..X.=..m..X|
|X%$$$X.......=.....X|
|X%$$$X.......=.m...X|
|XXXXXXXXXXXXXXXXXXXX|
+--------------------+
|XXXXXXXXXXXXXXXXXXXX|
|X%$$$X.......=.m...X|
|X%$$$X.......=.....D|
|X%$$$X..d..X.=..m..D|
|X%$$$X.......=.....D|
|X%$$$X.......=.m...X|
|XXXXXXXXXXXXXXXXXXXX|
+--------------------+
|XXXXXXXXXXXXXXXXXXXX|
|X%$$$X.......=.m...X|
|X%$$$X.......=.....X|
|X%$$$X..d..X.=..m..X|
|X%$$$X.......=.....X|
|X%$$$X.......=.m...X|
|XXXXXXXXXXXXXXXDDDXX|
+--------------------+
|XXXXXXXXXXXXXXXDDDXX|
|X%$$$X.......=.m...X|
|X%$$$X.......=.....X|
|X%$$$X..d..X.=..m..X|
|X%$$$X.......=.....X|
|X%$$$X.......=.m...X|
|XXXXXXXXXXXXXXXXXXXX|
+--------------------+
