+-------------------------------+
|       XXXXXXXXXXXXXXXXX       |
|     XXX...............XXX     |
|   XX.u........u..........XX   |
|  X......pX.u....$...u$.....X  |
| X.$.....XX.......X.......$..X |
|XX..$.......$................XX|
|X........u........u...u.......X|
|X.u.........X....u.........X..X|
|X.....XX...................X..X|
|X.....pX...................X..X|
|X.....XX.X....X....X....X..X..X|
|X..u..............u........X..X|
|X..........u............u..X..X|
|X.$....X...................X..X|
|XX..................X......X.XX|
| X...$.........u..........$X.X |
|  X.....$..........u.......XD  |
|   XX..XXXX...........u...XX   |
|     XXXppX.$........._XXX     |
|       XXXXXXXXXXXXXXXXX       |
+-------------------------------+
|       XXXXXXXXXXXXXXXXX       |
|     XXX.u.p..Xp.......XXX     |
|   Xu..u..u...X...-.......XX   |
|  X..uu..pu...X.............X  |
| XX===XXXXXXXXX..!X..........X |
|XX...........................XX|
|X.....!.......................X|
|X...........X.........!.......X|
|X...-......................X..X|
|X..............-..............X|
|X.............X....X....X..X!.X|
|X..............X....!.........X|
|X..........................X..X|
|X......X...................X..X|
|XX..................X........XX|
| X..-..........!...........X.X |
|  X........................XD  |
|   XX..XXXX..-............XX   |
|     XXXppX.!X.p.X...._XXX     |
|       XXXXXXXXXXXXXXXXX       |
+-------------------------------+
|       XXXXXXXXXXXXXXXXX       |
|     XXX...............XXX     |
|   XX.u........u..........XX   |
|  X......pX.u....$...u$.....X  |
| X.$.....XX.......X.......$..X |
|XX..$.......$................XX|
|X........u........u...u.......X|
|X.u.........X....u.........X..X|
|X.....XX...................X..X|
|X.....pX........d..........X..X|
|X.....XX.X....X....X....X..X..X|
|X..u..............u........X..X|
|X..........u............u..X..X|
|X.$....X...................X..X|
|XX..................X......X.XX|
| X...$.........u..........$X.X |
|  X.....$..........u.......XD  |
|   XX..XXXX...........u...XX   |
|     XXXppX.$........._XXX     |
|       XXXXXXXXXXXXXXXXX       |
+-------------------------------+
|       XXXXXXXXXXXXXXXXX       |
|     XXX......Xp.......XXX     |
|   XX.....d...X...-.......XX   |
|  X...........X.............X  |
| XX===XXXXXXXXX..!X..........X |
|XX...........................XX|
|X.....!.........!.............X|
|X.........!.X.........!.......X|
|X...-......................X..X|
|X..............-..............X|
|X.............X....X....X..X!.X|
|X...-....-.....X....!.........X|
|X....................-.....X..X|
|X..-...X.!!................X..X|
|XX..................X........XX|
| X..-..........!...........X.X |
|  X........................XD  |
|   XX..XXXX..-............XX   |
|     XXXppX.!X.p.X...._XXX     |
|       XXXXXXXXXXXXXXXXX       |
+-------------------------------+
