all normal
################################################################################
# These are the characters of the thing we will display. Frames of animation
# run sideways.
################################################################################
+------+------+------+------+------+------+------+------+------+------+------+------+------+------+------+------+------+------+------+------+------+------+------+------+------+------+------+------+------+------+------+------+
|-=--=-|- -=--|-=--=-|-=--=-|-=--=-|-=--=-|-=--=-|-=--=-|- -=--|-=--=-|-=--=-|-=--=-|- -=--|-=-- -|-=--=-|-=-_--|-=--=-|- -=--|-=--=-|-=--=-|-=--=-|-=--=-|-=--=-|-=--=-|- -=--|-=--=-|-=--=-|  -=--|- -=--|-=-- -|-=--=-|-=-_--|
|-=--_-|-=--=-|-=-- -|-=--_-|-=--_-|-=- - |- -=--|-=- --| -=- -|-_-- -|-=- --|-=--=-| -=---| -=---|-_-=--|-=--=-|-=--_-|-=--=-|-=-- -|-=--_-|-=--_-|-=- - |- -=--|-=- --| -=- -|-_-- -|-=- --|-=--=-| -=---| -=---|-_-=--|-=--=-|
|-=--=-|-=- --|-_-=--|-=- --|-=-_--|-=--=-|-=--- |-=--=-|-=- --|--_-=-|-=--- |-=--=-| -=- -|- -=- |_-=---|-=---_|-=--=-|-=- --|-_-=--|-=- --|-=-_--|-=--=-|-=--- |-=--=-|-=- --|--_-=-|-=--- |--  --|-=-- -|- -=- |_-=---|-=---_|
|-_-=--|-=--=-|-=--=-|-=-- -|  -=--|--_-=-|-=-- -|-=-- -|-=--=-|-=--=-|-=--=-|-=--=-| -=---| -=---| - -=-|-=--_-|-_-=--|-=--=-|-=--=-|-=-- -|  -=--|--_-=-|-=-- -|-=-- -|-=--=-|-  -=-|-=--=-|-=-  -| -=---| -=---| - -=-|-=--_-|
|-=-- -|- -=--|-=- --|-=--=-|- -=--|-=--- |-=--=-|-=-- -|- -=--|-=-_--|-=--=-|-=--=-|-=--=-|-=--=-|-- -_-|-=--=-|-=-- -|- -=--|-=- --|-=--=-|- -=--|-=--- |-=--=-|-=-- -|- -=--|-=-_--|-=-  -|-=--=-|-=--=-|-=--=-|-- -_-|-=--=-|
| -=---|-=--=-|-=--=-|-=--=-|- -=-_|-=--=-|--_-=-|-=--=-|-=--=-|-_-=--| -=---|-=--=-|- -=- |-- -=-|-- -=-|-=- --| -=---|-=--=-|-=--=-|-=--=-|- -=-_|-=--=-|--_-=-|-=--=-|-  -=-|-_-=--| -=---|-=--=-|- -=- |-- -=-|-=--=-|-=- --|
################################################################################
# These are the foreground colors for each frame of animation:
# 
#        black       w  white         r  red          E  dark_red
#     g  green       e  dark_green    y  yellow       b  blue
#     D  dark_blue   p  pink          c  cyan         R  random
#     _  gray        W  snow          o  orange       O  light_orange
#     G  lime        Y  light_yellow  B  light_blue   P  purple
#     C  light_cyan  0  gray_0        1  gray_1       2  gray_2
#     3  gray_3      4  gray_4        5  gray_5       6  gray_6
#     7  gray_7      8  gray_8        9  gray_9       n  brown
# 
################################################################################
+------+------+------+------+------+------+------+------+------+------+------+------+------+------+------+------+------+------+------+------+------+------+------+------+------+------+------+------+------+------+------+------+
|111111|111111|111111|111111|111111|111111|111111|111111|111111|111111|111111|111111|111111|131111|311113|111111|111111|111111|111111|111111|111111|111111|111111|111111|113111|131111|111111|311111|113111|131111|211113|111111|
|111111|111111|111111|111111|111111|111111|111111|133131|111111|111111|111111|111111|111111|331111|311111|111111|111111|111111|111111|111111|111111|111111|111111|133131|111111|311111|131111|111111|111111|331111|311111|111111|
|111331|111231|111131|111331|131311|111111|111331|111331|111331|111331|111331|111331|111331|111331|311131|111311|111331|111331|121331|111211|111331|111331|111331|111331|131311|111231|113331|111131|111331|111331|211131|111311|
|113111|112111|113111|113111|113111|111111|133111|133331|113111|113111|113111|113111|333111|113111|313111|112111|113111|112311|112111|113111|111111|112111|133111|133331|111111|113111|313311|113111|333111|113111|313111|113111|
|111111|111111|11o111|111111|111111|111111|331111|131331|111111|111111|111111|111111|131111|111111|331111|111121|121111|122111|11o111|111111|111111|111111|331111|131331|211111|111111|121111|111111|131111|111111|231111|111111|
|113111|111111|114111|113111|111111|113111|313111|133331|113111|113111|113111|113111|133111|113111|313111|111111|112111|112111|133111|113111|111111|113111|313111|133331|113111|111121|131111|113111|123111|111211|313111|112111|
################################################################################
# These are the background colors for each frame of animation:
# 
#        black       w  white         r  red          E  dark_red
#     g  green       e  dark_green    y  yellow       b  blue
#     D  dark_blue   p  pink          c  cyan         R  random
#     _  gray        W  snow          o  orange       O  light_orange
#     G  lime        Y  light_yellow  B  light_blue   P  purple
#     C  light_cyan  0  gray_0        1  gray_1       2  gray_2
#     3  gray_3      4  gray_4        5  gray_5       6  gray_6
#     7  gray_7      8  gray_8        9  gray_9       n  brown
# 
################################################################################
+------+------+------+------+------+------+------+------+------+------+------+------+------+------+------+------+------+------+------+------+------+------+------+------+------+------+------+------+------+------+------+------+
|      |      |      |      |      |      |      |      |      |      |      |      |      |      |      |      |      |      |      |      |      |      |      |      |      |      |      |      |      |      |      |      |
|      |      |      |      |      |      |      |      |      |      |      |      |      |      |      |      |      |      |      |      |      |      |      |      |      |      |      |      |      |      |      |      |
|      |      |      |      |      |      |      |      |      |      |      |      |      |      |      |      |      |      |      |      |      |      |      |      |      |      |      |      |      |      |      |      |
|      |      |      |      |      |      |      |      |      |      |      |      |      |      |      |      |      |      |      |      |      |      |      |      |      |      |      |      |      |      |      |      |
|      |      |      |      |      |      |      |      |      |      |      |      |      |      |      |      |      |      |      |      |      |      |      |      |      |      |      |      |      |      |      |      |
|      |      |      |      |      |      |      |      |      |      |      |      |      |      |      |      |      |      |      |      |      |      |      |      |      |      |      |      |      |      |      |      |
################################################################################
# This is the 'can bite' collision mask. Areas that bite or can be bitten.
################################################################################
+------+------+------+------+------+------+------+------+------+------+------+------+------+------+------+------+------+------+------+------+------+------+------+------+------+------+------+------+------+------+------+------+
|      |      |      |      |      |      |      |      |      |      |      |      |      |      |      |      |      |      |      |      |      |      |      |      |      |      |      |      |      |      |      |      |
|      |      |      |      |      |      |      |      |      |      |      |      |      |      |      |      |      |      |      |      |      |      |      |      |      |      |      |      |      |      |      |      |
|      |      |      |      |      |      |      |      |      |      |      |      |      |      |      |      |      |      |      |      |      |      |      |      |      |      |      |      |      |      |      |      |
|      |      |      |      |      |      |      |      |      |      |      |      |      |      |      |      |      |      |      |      |      |      |      |      |      |      |      |      |      |      |      |      |
|      |      |      |      |      |      |      |      |      |      |      |      |      |      |      |      |      |      |      |      |      |      |      |      |      |      |      |      |      |      |      |      |
|      |      |      |      |      |      |      |      |      |      |      |      |      |      |      |      |      |      |      |      |      |      |      |      |      |      |      |      |      |      |      |      |
################################################################################
# This is the obstacle collision mask. Areas used in collisions with walls etc..
################################################################################
+------+------+------+------+------+------+------+------+------+------+------+------+------+------+------+------+------+------+------+------+------+------+------+------+------+------+------+------+------+------+------+------+
|      |      |      |      |      |      |      |      |      |      |      |      |      |      |      |      |      |      |      |      |      |      |      |      |      |      |      |      |      |      |      |      |
|      |      |      |      |      |      |      |      |      |      |      |      |      |      |      |      |      |      |      |      |      |      |      |      |      |      |      |      |      |      |      |      |
|      |      |      |      |      |      |      |      |      |      |      |      |      |      |      |      |      |      |      |      |      |      |      |      |      |      |      |      |      |      |      |      |
|      |      |      |      |      |      |      |      |      |      |      |      |      |      |      |      |      |      |      |      |      |      |      |      |      |      |      |      |      |      |      |      |
|      |      |      |      |      |      |      |      |      |      |      |      |      |      |      |      |      |      |      |      |      |      |      |      |      |      |      |      |      |      |      |      |
|      |      |      |      |      |      |      |      |      |      |      |      |      |      |      |      |      |      |      |      |      |      |      |      |      |      |      |      |      |      |      |      |
################################################################################
# This is the 'touch' collision mask. How we interact with things, like doors.
################################################################################
+------+------+------+------+------+------+------+------+------+------+------+------+------+------+------+------+------+------+------+------+------+------+------+------+------+------+------+------+------+------+------+------+
|      |      |      |      |      |      |      |      |      |      |      |      |      |      |      |      |      |      |      |      |      |      |      |      |      |      |      |      |      |      |      |      |
|      |      |      |      |      |      |      |      |      |      |      |      |      |      |      |      |      |      |      |      |      |      |      |      |      |      |      |      |      |      |      |      |
|      |      |      |      |      |      |      |      |      |      |      |      |      |      |      |      |      |      |      |      |      |      |      |      |      |      |      |      |      |      |      |      |
|      |      |      |      |      |      |      |      |      |      |      |      |      |      |      |      |      |      |      |      |      |      |      |      |      |      |      |      |      |      |      |      |
|      |      |      |      |      |      |      |      |      |      |      |      |      |      |      |      |      |      |      |      |      |      |      |      |      |      |      |      |      |      |      |      |
|      |      |      |      |      |      |      |      |      |      |      |      |      |      |      |      |      |      |      |      |      |      |      |      |      |      |      |      |      |      |      |      |
+------+------+------+------+------+------+------+------+------+------+------+------+------+------+------+------+------+------+------+------+------+------+------+------+------+------+------+------+------+------+------+------+
