all normal
################################################################################
# These are the characters of the thing we will display. Frames of animation
# run sideways.
################################################################################
+------+------+------+------+------+------+------+------+------+------+------+------+------+------+------+------+
|......|......|......|......|......|....  |......|. ....|.. ...|... ..|`...`.|....  |..`...|......|...  .|`.. ..|
|.... .|.. ...|..... |. .` `|.... .|.`..`.|..`...| .....| ,..`.|. ... |.`....|.. .. |....`.|.`....|. ....|......|
|... ..|.. . .|. ....|.... .|...  .|......|. ....|......| .....|.. .. |. ...`|.,....|`... .|......| .....|..... |
|. ....|.... .|......|.`....|.`.. .|.` `..|.... .|...`..|...`..|......|...`..|.. ...|......|...`..|......|`... .|
|......|`.....|..... |......|......|....`.|......| .....|..,...|... ,.|`.....|.`.,..|..`...|.....`|.... .|.....`|
|......|......|....  |...`..|....` |..`...|.  ...|.. .. |......|. ....|....`.|......|....`.|...``.|......|.`....|
################################################################################
# These are the foreground colors for each frame of animation:
# 
#        black       w  white         r  red          E  dark_red
#     g  green       e  dark_green    y  yellow       b  blue
#     D  dark_blue   p  pink          c  cyan         R  random
#     _  gray        W  snow          o  orange       O  light_orange
#     G  lime        Y  light_yellow  B  light_blue   P  purple
#     C  light_cyan  0  gray_0        1  gray_1       2  gray_2
#     3  gray_3      4  gray_4        5  gray_5       6  gray_6
#     7  gray_7      8  gray_8        9  gray_9       n  brown
# 
################################################################################
+------+------+------+------+------+------+------+------+------+------+------+------+------+------+------+------+
|bbbbbb|bbbbbb|bbbbbb|bbbbbb|bbbbbb|bbbbbb|bbbbbb|bbbbbb|bbbbbb|bbbbbb|bbbbbb|bbbbbb|bbbbbb|b3bbbb|3bbbb3|bbbbbb|
|bbbbbb|bbbbbb|bbbbbb|bbbbbb|bbbbbb|bbbbbb|bbbbbb|b33b3b|bbbbbb|bbbbbb|bbbbbb|bbbbbb|bbbbbb|33bbbb|3bbbbb|bbbbbb|
|bbb33b|bbb33b|bbb33b|bbb33b|bbb33b|bbb33b|bbb33b|bbb33b|bbb33b|bbb33b|bbb33b|bbb33b|bbb33b|bbb33b|3bbb3b|bbb3bb|
|bb3bbb|bb3bbb|bb3bbb|bb3bbb|bb3bbb|bb3bbb|b33bbb|b3333b|bb3bbb|bb3bbb|bb3bbb|bb3bbb|333bbb|bb3bbb|3b3bbb|bb3bbb|
|bbbbbb|bbbbbb|bbobbb|bbbbbb|bbbbbb|bbbbbb|33bbbb|b3b33b|bbbbbb|bbbbbb|bbbbbb|bbbbbb|b3bbbb|bbbbbb|33bbbb|bbbbbb|
|bb3bbb|bb3bbb|bb3bbb|bb3bbb|bb3bbb|bb3bbb|3b3bbb|b3333b|bb3bbb|bb3bbb|bb3bbb|bb3bbb|b33bbb|bb3bbb|3b3bbb|bb3bbb|
################################################################################
# These are the background colors for each frame of animation:
# 
#        black       w  white         r  red          E  dark_red
#     g  green       e  dark_green    y  yellow       b  blue
#     D  dark_blue   p  pink          c  cyan         R  random
#     _  gray        W  snow          o  orange       O  light_orange
#     G  lime        Y  light_yellow  B  light_blue   P  purple
#     C  light_cyan  0  gray_0        1  gray_1       2  gray_2
#     3  gray_3      4  gray_4        5  gray_5       6  gray_6
#     7  gray_7      8  gray_8        9  gray_9       n  brown
# 
################################################################################
+------+------+------+------+------+------+------+------+------+------+------+------+------+------+------+------+
|      |      |      |      |      |      |      |      |      |      |      |      |      |      |      |      |
|      |      |      |      |      |      |      |      |      |      |      |      |      |      |      |      |
|      |      |      |      |      |      |      |      |      |      |      |      |      |      |      |      |
|      |      |      |      |      |      |      |      |      |      |      |      |      |      |      |      |
|      |      |      |      |      |      |      |      |      |      |      |      |      |      |      |      |
|      |      |      |      |      |      |      |      |      |      |      |      |      |      |      |      |
################################################################################
# This is the 'can bite' collision mask. Areas that bite or can be bitten.
################################################################################
+------+------+------+------+------+------+------+------+------+------+------+------+------+------+------+------+
|      |      |      |      |      |      |      |      |      |      |      |      |      |      |      |      |
|      |      |      |      |      |      |      |      |      |      |      |      |      |      |      |      |
|      |      |      |      |      |      |      |      |      |      |      |      |      |      |      |      |
|      |      |      |      |      |      |      |      |      |      |      |      |      |      |      |      |
|      |      |      |      |      |      |      |      |      |      |      |      |      |      |      |      |
|      |      |      |      |      |      |      |      |      |      |      |      |      |      |      |      |
################################################################################
# This is the obstacle collision mask. Areas used in collisions with walls etc..
################################################################################
+------+------+------+------+------+------+------+------+------+------+------+------+------+------+------+------+
|      |      |      |      |      |      |      |      |      |      |      |      |      |      |      |      |
|      |      |      |      |      |      |      |      |      |      |      |      |      |      |      |      |
|      |      |      |      |      |      |      |      |      |      |      |      |      |      |      |      |
|      |      |      |      |      |      |      |      |      |      |      |      |      |      |      |      |
|      |      |      |      |      |      |      |      |      |      |      |      |      |      |      |      |
|      |      |      |      |      |      |      |      |      |      |      |      |      |      |      |      |
################################################################################
# This is the 'touch' collision mask. How we interact with things, like doors.
################################################################################
+------+------+------+------+------+------+------+------+------+------+------+------+------+------+------+------+
|      |      |      |      |      |      |      |      |      |      |      |      |      |      |      |      |
|      |      |      |      |      |      |      |      |      |      |      |      |      |      |      |      |
|      |      |      |      |      |      |      |      |      |      |      |      |      |      |      |      |
|      |      |      |      |      |      |      |      |      |      |      |      |      |      |      |      |
|      |      |      |      |      |      |      |      |      |      |      |      |      |      |      |      |
|      |      |      |      |      |      |      |      |      |      |      |      |      |      |      |      |
+------+------+------+------+------+------+------+------+------+------+------+------+------+------+------+------+
