all normal
################################################################################
# These are the characters of the thing we will display. Frames of animation
# run sideways.
################################################################################
+------+------+------+------+------+------+------+------+------+------+------+------+------+------+------+------+
|___ __| _____|__ ___| _____|_ ____|__ ___|_____ |__ ___|__ ___|__ ___|__ ___|____ _|______|______|______|______|
|_ ____|__ ___|_ ____|_ ____| _____|___ __|__ ___|____ _|_____ |_____ |_____ |___ __|___ __|______|______|___ __|
|____ _|____ _|___ __|___ __|__ ___| _____| ____ |_ ____|_ ____|_ ____|__ ___| _____|_ __ _|__ ___|__ ___|_ ____|
|___ __|_ ____|_ ____|______|____ _|___ __|_ ____|__ ___|____ _|_ ____|____ _|_ ____|______|______|______|______|
|______|_____ |_____ |_ _ __|______|__ ___|___ __| _____|__ ___|_____ | _____|____ _|___ __|___ __|______|______|
|____ _|____ _|___ __|____ _|__ ___| ____ |_ ____|____ _|___ __|__ ___|_ ____| _____|_ ____|_____ |__ ___|______|
################################################################################
# These are the foreground colors for each frame of animation:
# 
#        black       w  white         r  red          E  dark_red
#     g  green       e  dark_green    y  yellow       b  blue
#     D  dark_blue   p  pink          c  cyan         R  random
#     _  gray        W  snow          o  orange       O  light_orange
#     G  lime        Y  light_yellow  B  light_blue   P  purple
#     C  light_cyan  0  gray_0        1  gray_1       2  gray_2
#     3  gray_3      4  gray_4        5  gray_5       6  gray_6
#     7  gray_7      8  gray_8        9  gray_9       n  brown
# 
################################################################################
+------+------+------+------+------+------+------+------+------+------+------+------+------+------+------+------+
|nnnnnn|nnnnnn|nnnnnn|nnnnnn|nnnnnn|nnnnnn|nnnnnn|nnnnnn|nnnnnn|nnnnnn|nnnnnn|nnnnnn|nnnnnn|n3nnnn|3nnnn3|nnnnnn|
|nnnnnn|nnnnnn|nnnnnn|nnnnnn|nnnnnn|nnnnnn|nnnnnn|n33n3n|nnnnnn|nnnnnn|nnnnnn|nnnnnn|nnnnnn|33nnnn|3nnnnn|nnnnnn|
|nnn33n|nnn33n|nnn33n|nnn33n|nnn33n|nnn33n|nnn33n|nnn33n|nnn33n|nnn33n|nnn33n|nnn33n|nnn33n|nnn33n|3nnn3n|nnn3nn|
|nn3nnn|nn3nnn|nn3nnn|nn3nnn|nn3nnn|nn3nnn|n33nnn|n3333n|nn3nnn|nn3nnn|nn3nnn|nn3nnn|333nnn|nn3nnn|3n3nnn|nn3nnn|
|nnnnnn|nnnnnn|nnonnn|nnnnnn|nnnnnn|nnnnnn|33nnnn|n3n33n|nnnnnn|nnnnnn|nnnnnn|nnnnnn|n3nnnn|nnnnnn|33nnnn|nnnnnn|
|nn3nnn|nn3nnn|nn3nnn|nn3nnn|nn3nnn|nn3nnn|3n3nnn|n3333n|nn3nnn|nn3nnn|nn3nnn|nn3nnn|n33nnn|nn3nnn|3n3nnn|nn3nnn|
################################################################################
# These are the background colors for each frame of animation:
# 
#        black       w  white         r  red          E  dark_red
#     g  green       e  dark_green    y  yellow       b  blue
#     D  dark_blue   p  pink          c  cyan         R  random
#     _  gray        W  snow          o  orange       O  light_orange
#     G  lime        Y  light_yellow  B  light_blue   P  purple
#     C  light_cyan  0  gray_0        1  gray_1       2  gray_2
#     3  gray_3      4  gray_4        5  gray_5       6  gray_6
#     7  gray_7      8  gray_8        9  gray_9       n  brown
# 
################################################################################
+------+------+------+------+------+------+------+------+------+------+------+------+------+------+------+------+
|      |      |      |      |      |      |      |      |      |      |      |      |      |      |      |      |
|      |      |      |      |      |      |      |      |      |      |      |      |      |      |      |      |
|      |      |      |      |      |      |      |      |      |      |      |      |      |      |      |      |
|      |      |      |      |      |      |      |      |      |      |      |      |      |      |      |      |
|      |      |      |      |      |      |      |      |      |      |      |      |      |      |      |      |
|      |      |      |      |      |      |      |      |      |      |      |      |      |      |      |      |
################################################################################
# This is the 'can bite' collision mask. Areas that bite or can be bitten.
################################################################################
+------+------+------+------+------+------+------+------+------+------+------+------+------+------+------+------+
|      |      |      |      |      |      |      |      |      |      |      |      |      |      |      |      |
|      |      |      |      |      |      |      |      |      |      |      |      |      |      |      |      |
|      |      |      |      |      |      |      |      |      |      |      |      |      |      |      |      |
|      |      |      |      |      |      |      |      |      |      |      |      |      |      |      |      |
|      |      |      |      |      |      |      |      |      |      |      |      |      |      |      |      |
|      |      |      |      |      |      |      |      |      |      |      |      |      |      |      |      |
################################################################################
# This is the obstacle collision mask. Areas used in collisions with walls etc..
################################################################################
+------+------+------+------+------+------+------+------+------+------+------+------+------+------+------+------+
|      |      |      |      |      |      |      |      |      |      |      |      |      |      |      |      |
|      |      |      |      |      |      |      |      |      |      |      |      |      |      |      |      |
|      |      |      |      |      |      |      |      |      |      |      |      |      |      |      |      |
|      |      |      |      |      |      |      |      |      |      |      |      |      |      |      |      |
|      |      |      |      |      |      |      |      |      |      |      |      |      |      |      |      |
|      |      |      |      |      |      |      |      |      |      |      |      |      |      |      |      |
################################################################################
# This is the 'touch' collision mask. How we interact with things, like doors.
################################################################################
+------+------+------+------+------+------+------+------+------+------+------+------+------+------+------+------+
|      |      |      |      |      |      |      |      |      |      |      |      |      |      |      |      |
|      |      |      |      |      |      |      |      |      |      |      |      |      |      |      |      |
|      |      |      |      |      |      |      |      |      |      |      |      |      |      |      |      |
|      |      |      |      |      |      |      |      |      |      |      |      |      |      |      |      |
|      |      |      |      |      |      |      |      |      |      |      |      |      |      |      |      |
|      |      |      |      |      |      |      |      |      |      |      |      |      |      |      |      |
+------+------+------+------+------+------+------+------+------+------+------+------+------+------+------+------+
