+-----------------+
|XXXXXXXXXXXXXXXXX|
|X$GX..........G$X|
|XGXXX.......XXXGX|
|X..XX.......XXX.X|
|X..XX.......XXX.X|
|X..XXXXX.XXXX...X|
|X...XXXXGX......X|
|X.....GXXX......X|
|X.G....XGX......X|
|XXX.XXXX.XXXX...X|
|X$$$X.......XXX.X|
|X$$$X.......XXX.X|
|X$$$X.......XXX.X|
|XG$$X.......XXXGX|
|X$$$X.........G$X|
|XXXXXXXDDDXXXXXXX|
+-----------------+
|XXXXXXXXXXXXXXXXX|
|X$GX..........G$X|
|XGXXX.......XXXGX|
|X..XX.......XXX.X|
|X..XX.......XXX.X|
|X..XXXXX.XXXX...X|
|X...XXXXGX......X|
|X.....GXXX......X|
|X.G....XGX......X|
|XXX.XXXX.XXXX...X|
|Xp$$X.......XXX.X|
|X$p$X.......XXX.X|
|X$$pX.......XXX.X|
|XG$$X.......XXXGX|
|X$$$X.........G$X|
|XXXXXXXDDDXXXXXXX|
+-----------------+
|XXXXXXXXXXXXXXXXX|
|X$GX..........G$X|
|XGXXX...p...XXXGX|
|X..XX.......XXX.X|
|X..XX.......XXX.X|
|X..XXXXX.XXXX...X|
|X...XXXXGX......X|
|X.....GXXX......X|
|X.G....XGX......X|
|XXX.XXXX.XXXX...X|
|Xp$$X.......XXX.X|
|X$p$X.......XXX.X|
|X$$pX...p...XXX.X|
|XG$$X.......XXXGX|
|X$$$X.........G$X|
|XXXXXXXDDDXXXXXXX|
+-----------------+
|XXXXXXXXXXXXXXXXX|
|X$GX..........G$X|
|XGXXX...p...XXXGX|
|X..XX.......XXX.X|
|X..XX.......XXX.X|
|X..XXXXX.XXXX...X|
|X...XXXXGX......X|
|X.....GXXX......X|
|X.G....XGX......X|
|XXX.XXXX.XXXX...X|
|Xp$$X..$..$.XXX.X|
|X$p$X.$.$...XXX.X|
|X$$pX=======XXX.X|
|XG$$X.......XXXGX|
|X$$$X.........G$X|
|XXXXXXXDDDXXXXXXX|
+-----------------+
|XXXXXXXXXXXXXXXXX|
|X$GX..........G$X|
|XGXXX...p...XXXGX|
|X..XX.......XXX.X|
|X..XX.......XXX.X|
|X..XXXXX.XXXX...X|
|X...XXXXGX......X|
|X.....GXXX......X|
|X.G....XGX......X|
|XXX.XXXX.XXXX...X|
|Xp$$X..p..p.XXX.X|
|X$p$X.p.p...XXX.X|
|X$$pX=======XXX.X|
|XG$$X.......XXXGX|
|X$$$X.........G$X|
|XXXXXXXDDDXXXXXXX|
+-----------------+
|XXXXXXXXXXXXXXXXX|
|X$GX..........G$X|
|XGXXX...M...XXXGX|
|X..XX.......XXX.X|
|X..XX.......XXX.X|
|X..XXXXX.XXXX...X|
|X...XXXXGX......X|
|X.....GXXX......X|
|X.G....XGX......X|
|XXX.XXXX.XXXX...X|
|Xp$$X..M....XXX.X|
|X$p$X.......XXX.X|
|X$$pX=======XXX.X|
|XG$$X.......XXXGX|
|X$$$X.........G$X|
|XXXXXXXDDDXXXXXXX|
+-----------------+
|XXXXXXXXXXXXXXXXX|
|X$GX..........G$X|
|XGXXX...M...XXXGX|
|X..XX.......XXX.X|
|X..XX.......XXX.X|
|X..XXXXX.XXXX...X|
|X...XXXXGX......X|
|X.....GXXX...M..X|
|X.G....XGX......X|
|XXX.XXXX.XXXX...X|
|Xp$$X.......XXX.X|
|X$p$X.......XXX.X|
|X$$pX.......XXX.X|
|XG$$X.......XXXGX|
|X$$$X.........G$X|
|XXXXXXXDDDXXXXXXX|
+-----------------+
|XXXXXXXXXXXXXXXXX|
|X$GX..........G$X|
|X$GX..........G$X|
|X$GX..........G$X|
|XGXXX.......XXXGX|
|X..XX.......XXX.X|
|X..XX.......XXX.X|
|X..XXXXX.XXXX...X|
|X...XXXXGX......X|
|X.....GXXX......X|
|X.G....XGX......X|
|XXX.XXXX.XXXX...X|
|XM$$X.......XXX.X|
|X$M$X.......XXX.X|
|X$$pX...M...XXX.X|
|XM$$X.......XXXGX|
|X$$$X.........G$X|
|X$$$X.........G$X|
|X$$$X.........G$X|
|X$$$X.........G$X|
|XXXXXXXDDDXXXXXXX|
+-----------------+
|XXXXXXXXXXXXXXXXX|
|X$GX..........G$X|
|X$GX..........G$X|
|X$GX..........G$X|
|XGXXX...M...XXXGX|
|X..XX.......XXX.X|
|X..XX.......XXX.X|
|X..XXXXX.XXXX...X|
|X...XXXXGX......X|
|X.....GXXX......X|
|X.G....XGX......X|
|XXX.XXXX.XXXX...X|
|XM$$X.......XXX.X|
|X$M$X.......XXX.X|
|X$$pX.......XXX.X|
|XM$$X.......XXXGX|
|X$$$X.........G$X|
|X$$$X.........G$X|
|X$$$X.........G$X|
|X$$$X.........G$X|
|XXXXXXXDDDXXXXXXX|
+-----------------+
|XXXXXXXXXXXXXXXXX|
|X$GX..........G$X|
|X$GX..........G$X|
|X$GX..........G$X|
|XGXXX.......XXXGX|
|X..XX.......XXX.X|
|X..XX.......XXX.X|
|X..XXXXX.XXXX...X|
|X...XXXXGX......X|
|X.....GXXX...M..X|
|X.G....XGX......X|
|XXX.XXXX.XXXX...X|
|XM$$X.......XXX.X|
|X$M$X.......XXX.X|
|X$$pX.......XXX.X|
|XM$$X.......XXXGX|
|X$$$X.........G$X|
|X$$$X.........G$X|
|X$$$X.........G$X|
|X$$$X.........G$X|
|XXXXXXXDDDXXXXXXX|
+-----------------+
|XXXXXXXXXXXXXXXXX|
|X$GX..........G$X|
|X$GX..........G$X|
|X$GX..........G$X|
|XGXXX.......XXXGX|
|X..XX.......XXX.X|
|X..XX.......XXX.X|
|X..XXXXX.XXXX...X|
|X...XXXXGX......X|
|X.....GXXX......X|
|X..M...XGX......X|
|X.....GXXX......X|
|XXX.XXXX.XXXX...X|
|XM$$X.......XXX.X|
|X$M$X.......XXX.X|
|X$$pX.......XXX.X|
|XM$$X.......XXXGX|
|X$$$X.........G$X|
|X$$$X.........G$X|
|X$$$X.........G$X|
|X$$$X.........G$X|
|XXXXXXXDDDXXXXXXX|
+-----------------+
