+-----------------+
|XXXXXXXXXXXXXXXXX|
|X......G...G....X|
|X........G......X|
|X.XXXXXXXXXXXXX.X|
|XGXG...G......XGX|
|X.X.XXXXXXXXXGX.X|
|X.X.X...G...X.X.X|
|X.XGX.XXXXXGX.X.X|
|X.X.X.XpppX.XGX.X|
|X.X.X.XpppX.X.X.X|
|X.X.X.XpppXGX.XGX|
|XGXGX.XXXGX.X.X.X|
|X.X.X.M...X.XGX.X|
|X.X.XXXXXXX.X.X.X|
|X.XG........X.X.X|
|X.XXXXXXXXXXX.XGX|
|X...G.....G...X.X|
|XG.....G......X.D|
|XXXXXXXXXXXXXXXXX|
+-----------------+
|XXXXXXXXXXXXXXXXX|
|X.......G.......X|
|X..G........G...X|
|X.XXXXXXXXXXXXX.X|
|X.X...........X.X|
|X.X.XXXXXXXXX.X.X|
|XGX.X....G..X.X.X|
|X.XGX.XXXXX.X.X.X|
|X.X.X.Xpp.X.X.XGX|
|X.X.X.Xpp.X.XGX.X|
|X.X.X.Xpp.X.X.X.X|
|X.XGX.XXX!X.X.X.X|
|X.X.X.G.G.X.X.X.X|
|X.X.XXXXXXX.G.X.X|
|X.X.........X.XGX|
|X.XXXXXXXXXXX.X.X|
|X.......G.....X.X|
|X....G........X.D|
|XXXXXXXXXXXXXXXXX|
+-----------------+
|XXXXXXXXXXXXXXXXX|
|X.............._X|
|X_............_.X|
|X.XXXXXXXXXXXXX.X|
|X.X_..........X.X|
|X.X.XXXXXXXXX.X.X|
|X.X.X......_X.X.X|
|X.X.X.XXXXX.X.X.X|
|X.X.X.Xpp.X.X.X.X|
|X.X.X.Xpp.X.X.X.X|
|X.X.X.Xpp.X.X.X.X|
|X.X.X.XXX!X.X.X.X|
|X.X.X...M.X.X.X.X|
|X.X.XXXXXXX.X.X.X|
|X.X_......._X.X.X|
|X.XXXXXXXXXXX.X.X|
|X...._......._X.X|
|X_...._....._.X.D|
|XXXXXXXXXXXXXXXXX|
+-----------------+
|XXXXXXXXXXXXXXXXX|
|X...............X|
|X...............X|
|X.XXXXXXXXXXXXX.X|
|X.X...........X.X|
|X.X.XXXXXXXXX.X.X|
|X.X.X.......X.X.X|
|X.X.X.XXXXX.X.X.X|
|X.X.X.XGGGX.X.X.X|
|X.X.X.XGpGX.X.X.X|
|X.X.X.XGGGX.X.X.X|
|X.X.X.XXXDX.X.X.X|
|X.X.X...M.X.X.X.X|
|X.X.XXXXXXX.X.X.X|
|X.X.........X.X.X|
|X.XXXXXXXXXXX.X.X|
|X.............X.X|
|X.............X.D|
|XXXXXXXXXXXXXXXXX|
+-----------------+
|XXXXXXXXXXXXXXXXX|
|XppG.G.G.G.G....X|
|Xpp.G.G.G.G.G...X|
|XpXXXXXXXXXXXXX.X|
|X.X...........X.X|
|X.X.XXXXXXXXX.X.X|
|X.X.X....G..X.X.X|
|X.X.X.XXXXX.XGX.X|
|X.X.X.XpppX.X.X.X|
|X.X.XGXpppX.X.X.X|
|X.X.X.XpppX.X.X.X|
|X.X.X.XXXGX.X.X.X|
|X.X.X...M.X.X.X.X|
|X.X.XXXXXXX.X.X.X|
|X.X.........XGX.X|
|X.XXXXXXXXXXX.X.X|
|X.G.G.........X.X|
|X..G.G........X.D|
|XXXXXXXXXXXXXXXXX|
+-----------------+
|XXXXXXXXXXXXXXXXX|
|XG.............GX|
|X.G...........G.X|
|X.XXXXXXXXXXXXX.X|
|X.XG..........X.X|
|X.X.XXXXXXXXX.X.X|
|X.X.XG......XGX.X|
|X.X.X.XXXXX.X.X.X|
|X.X.X.XpppX.X.X.X|
|X.X.X.XpppX.X.X.X|
|X.X.X.XpppX.X.X.X|
|X.X.X.XXX_X.X.X.X|
|X.X.XG..M.X.X.X.X|
|X.X.XXXXXXX.XGX.X|
|X.XG........X.X.X|
|X.XXXXXXXXXXX.X.X|
|X.G...........XGX|
|XG............X.D|
|XXXXXXXXXXXXXXXXX|
+-----------------+
|XXXXXXXXXXXXXXXXX|
|X..G...........GX|
|X.G.G.........G.X|
|X.XXXXXXXXXXXXX.X|
|X.XG.........GX.X|
|X.X.XXXXXXXXX.X.X|
|X.X.XG.....GX.X.X|
|X.X.X.XXXXX.X.X.X|
|X.X.X.XpppX.X.X.X|
|X.X.X.XpppX.X.X.X|
|X.X.X.XpppX.X.X.X|
|X.X.X.XDDDX.X.X.X|
|X.X.XG..M.X.X.XGX|
|X.X.XXXXXXX.X.X.X|
|X.XG........X.X.X|
|X.XXXXXXXXXXX.X.X|
|X..G.......G..X.X|
|X.G.......G...X.D|
|XXXXXXXXXXXXXXXXX|
+-----------------+
